*S**********
*          *
* ******** S
*    *   * *
*** ** * * *
*      * * *
********G***